 1  80  80  80  80  80  80  80  80  80  80  80  255 255 255 255 255 255 255 255 255 255 255 40  40  40  40  40  40  40  40  40  40  40  90  90  90  90  90  90  90  90  90  90  90  50  50  50  50  50  50  50  50  50  50
 2  80  80  80  80  80  80  80  80  80  80  80  255 255 255 255 255 255 255 255 255 255 255 40  40  40  40  40  40  40  40  40  40  40  90  90  90  90  90  90  90  90  90  90  90  50  50  50  50  50  50  50  50  50  50
 3  80  80  80  80  80  80  80  80  80  80  80  255 255 255 255 255 255 255 255 255 255 255 40  40  40  40  40  40  40  40  40  40  40  90  90  90  90  90  90  90  90  90  90  90  50  50  50  50  50  50  50  50  50  50
 4  80  80  80  80  80  80  80  80  80  80  80  255 255 255 255 255 255 255 255 255 255 255 40  40  40  40  40  40  40  40  40  40  40  90  90  90  90  90  90  90  90  90  90  90  50  50  50  50  50  50  50  50  50  50
 5  80  80  80  80  80  80  80  80  80  80  80  255 255 255 255 255 255 255 255 255 255 255 40  40  40  40  40  40  40  40  40  40  40  90  90  90  90  90  90  90  90  90  90  90  50  50  50  50  50  50  50  50  50  50
 6  80  80  80  80  80  80  80  80  80  80  80  255 255 255 255 255 255 255 255 255 255 255 40  40  40  40  40  40  40  40  40  40  40  90  90  90  90  90  90  90  90  90  90  90  50  50  50  50  50  50  50  50  50  50
 7  80  80  80  80  80  80  80  80  80  80  80  255 255 255 255 255 255 255 255 255 255 255 40  40  40  40  40  40  40  40  40  40  40  90  90  90  90  90  90  90  90  90  90  90  50  50  50  50  50  50  50  50  50  50
 8  80  80  80  80  80  80  80  80  80  80  80  255 255 255 255 255 255 255 255 255 255 255 40  40  40  40  40  40  40  40  40  40  40  90  90  90  90  90  90  90  90  90  90  90  50  50  50  50  50  50  50  50  50  50
 9  80  80  80  80  80  80  80  80  80  80  80  255 255 255 255 255 255 255 255 255 255 255 40  40  40  40  40  40  40  40  40  40  40  90  90  90  90  90  90  90  90  90  90  90  50  50  50  50  50  50  50  50  50  50
10  80  80  80  80  80  80  80  80  80  80  80  255 255 255 255 255 255 255 255 255 255 255 40  40  40  40  40  40  40  40  40  40  40  90  90  90  90  90  90  90  90  90  90  90  50  50  50  50  50  50  50  50  50  50
11  80  80  80  80  80  80  80  80  80  80  80  255 255 255 255 255 255 255 255 255 255 255 40  40  40  40  40  40  40  40  40  40  40  90  90  90  90  90  90  90  90  90  90  90  50  50  50  50  50  50  50  50  50  50
12  10  10  10  10  10  10  10  10  10  10  10  255 255 255 255 255 255 255 255 255 255 255 40  40  40  40  40  40  40  40  40  40  40  90  90  90  90  90  90  90  90  90  90  90  50  50  50  50  50  50  50  50  50  50
13  10  10  10  10  10  10  10  10  10  10  10  255 255 255 255 255 255 255 255 255 255 255 40  40  40  40  40  40  40  40  40  40  40  90  90  90  90  90  90  90  90  90  90  90  50  50  50  50  50  50  50  50  50  50
14  10  10  10  10  10  10  10  10  10  10  10  255 255 255 255 255 255 255 255 255 255 255 40  40  40  40  40  40  40  40  40  40  40  90  90  90  90  90  90  90  90  90  90  90  50  50  50  50  50  50  50  50  50  50
15  10  10  10  10  10  10  10  10  10  10  10  255 255 255 255 255 255 255 255 255 255 255 40  40  40  40  40  40  40  40  40  40  40  90  90  90  90  90  90  90  90  90  90  90  50  50  50  50  50  50  50  50  50  50
16  10  10  10  10  10  10  10  10  10  10  10  255 255 255 255 255 255 255 255 255 255 255 40  40  40  40  40  40  40  40  40  40  40  90  90  90  90  90  90  90  90  90  90  90  50  50  50  50  50  50  50  50  50  50
17  10  10  10  10  10  10  10  10  10  10  10  255 255 255 255 255 255 255 255 255 255 255 40  40  40  40  40  40  40  40  40  40  40  90  90  90  90  90  90  90  90  90  90  90  50  50  50  50  50  50  50  50  50  50
18  10  10  10  10  10  10  10  10  10  10  10  255 255 255 255 255 255 255 255 255 255 255 40  40  40  40  40  40  40  40  40  40  40  90  90  90  90  90  90  90  90  90  90  90  50  50  50  50  50  50  50  50  50  50
19  10  10  10  10  10  10  10  10  10  10  10  255 255 255 255 255 255 255 255 255 255 255 40  40  40  40  40  40  40  40  40  40  40  90  90  90  90  90  90  90  90  90  90  90  50  50  50  50  50  50  50  50  50  50
20  10  10  10  10  10  10  10  10  10  10  10  255 255 255 255 255 255 255 255 255 255 255 40  40  40  40  40  40  40  40  40  40  40  90  90  90  90  90  90  90  90  90  90  90  50  50  50  50  50  50  50  50  50  50
21  10  10  10  10  10  10  10  10  10  10  10  255 255 255 255 255 255 255 255 255 255 255 40  40  40  40  40  40  40  40  40  40  40  90  90  90  90  90  90  90  90  90  90  90  50  50  50  50  50  50  50  50  50  50
22  10  10  10  10  10  10  10  10  10  10  10  255 255 255 255 255 255 255 255 255 255 255 40  40  40  40  40  40  40  40  40  40  40  90  90  90  90  90  90  90  90  90  90  90  50  50  50  50  50  50  50  50  50  50
23  10  10  10  10  10  10  10  10  10  10  10  255 255 255 255 255 255 255 255 255 255 255 40  40  40  40  40  40  40  40  40  40  40  90  90  90  90  90  90  90  90  90  90  90  10  10  10  10  10  10  10  10  10  10
24  10  10  10  10  10  10  10  10  10  10  10  255 255 255 255 255 255 255 255 255 255 255 40  40  40  40  40  40  40  40  40  40  40  90  90  90  90  90  90  90  90  90  90  90  10  10  10  10  10  10  10  10  10  10
25  10  10  10  10  10  10  10  10  10  10  10  255 255 255 255 255 255 255 255 255 255 255 40  40  40  40  40  40  40  40  40  40  40  90  90  90  90  90  90  90  90  90  90  90  10  10  10  10  10  10  10  10  10  10
26  10  10  10  10  10  10  10  10  10  10  10  255 255 255 255 255 255 255 255 255 255 255 40  40  40  40  40  40  40  40  40  40  40  90  90  90  90  90  90  90  90  90  90  90  10  10  10  10  10  10  10  10  10  10
27  10  10  10  10  10  10  10  10  10  10  10  70  70  70  70  70  70  70  70  70  70  70  40  40  40  40  40  40  40  40  40  40  40  90  90  90  90  90  90  90  90  90  90  90  10  10  10  10  10  10  10  10  10  10
28  10  10  10  10  10  10  10  10  10  10  10  70  70  70  70  70  70  70  70  70  70  70  40  40  40  40  40  40  40  40  40  40  40  90  90  90  90  90  90  90  90  90  90  90  10  10  10  10  10  10  10  10  10  10
29  10  10  10  10  10  10  10  10  10  10  10  70  70  70  70  70  70  70  70  70  70  70  40  40  40  40  40  40  40  40  40  40  40  90  90  90  90  90  90  90  90  90  90  90  10  10  10  10  10  10  10  10  10  10
30  10  10  10  10  10  10  10  10  10  10  10  70  70  70  70  70  70  70  70  70  70  70  40  40  40  40  40  40  40  40  40  40  40  90  90  90  90  90  90  90  90  90  90  90  10  10  10  10  10  10  10  10  10  10
31  10  10  10  10  10  10  10  10  10  10  10  255 255 255 255 255 255 255 255 255 255 255 40  40  40  40  40  40  40  40  40  40  40  90  90  90  90  90  90  90  90  90  90  90  10  10  10  10  10  10  10  10  10  10
32  10  10  10  10  10  10  10  10  10  10  10  255 255 255 255 255 255 255 255 255 255 255 40  40  40  40  40  40  40  40  40  40  40  90  90  90  90  90  90  90  90  90  90  90  10  10  10  10  10  10  10  10  10  10
33  10  10  10  10  10  10  10  10  10  10  10  255 255 255 255 255 255 255 255 255 255 255 40  40  40  40  40  40  40  40  40  40  40  90  90  90  90  90  90  90  90  90  90  90  10  10  10  10  10  10  10  10  10  10
34  10  10  10  10  10  10  10  10  10  10  10  255 255 255 255 255 255 255 255 255 255 255 40  40  40  40  40  40  40  40  40  40  40  255 255 255 255 255 255 255 255 255 255 255 10  10  10  10  10  10  10  10  10  10
35  10  10  10  10  10  10  10  10  10  10  10  255 255 255 255 255 255 255 255 255 255 255 40  40  40  40  40  40  40  40  40  40  40  255 255 255 255 255 255 255 255 255 255 255 10  10  10  10  10  10  10  10  10  10
36  10  10  10  10  10  10  10  10  10  10  10  255 255 255 255 255 255 255 255 255 255 255 40  40  40  40  40  40  40  40  40  40  40  255 255 255 255 255 255 255 255 255 255 255 10  10  10  10  10  10  10  10  10  10
37  10  10  10  10  10  10  10  10  10  10  10  255 255 255 255 255 255 255 255 255 255 255 40  40  40  40  40  40  40  40  40  40  40  255 255 255 255 255 255 255 255 255 255 255 10  10  10  10  10  10  10  10  10  10
38  10  10  10  10  10  10  10  10  10  10  10  255 255 255 255 255 255 255 255 255 255 255 40  40  40  40  40  40  40  40  40  40  40  255 255 255 255 255 255 255 255 255 255 255 10  10  10  10  10  10  10  10  10  10
39  10  10  10  10  10  10  10  10  10  10  10  255 255 255 255 255 255 255 255 255 255 255 40  40  40  40  40  40  40  40  40  40  40  255 255 255 255 255 255 255 255 255 255 255 10  10  10  10  10  10  10  10  10  10
40  10  10  10  10  10  10  10  10  10  10  10  255 255 255 255 255 255 255 255 255 255 255 40  40  40  40  40  40  40  40  40  40  40  255 255 255 255 255 255 255 255 255 255 255 10  10  10  10  10  10  10  10  10  10
41  10  10  10  10  10  10  10  10  10  10  10  255 255 255 255 255 255 255 255 255 255 255 255 255 255 255 255 255 255 255 255 255 255 255 255 255 255 255 255 255 255 255 255 255 10  10  10  10  10  10  10  10  10  10
42  10  10  10  10  10  10  10  10  10  10  10  255 255 255 255 255 255 255 255 255 255 255 255 255 255 255 255 255 255 255 255 255 255 255 255 255 255 255 255 255 255 255 255 255 10  10  10  10  10  10  10  10  10  10
43  10  10  10  10  10  10  10  10  10  10  10  255 255 255 255 255 255 255 255 255 255 255 255 255 255 255 255 255 255 255 255 255 255 255 255 255 255 255 255 255 255 255 255 255 10  10  10  10  10  10  10  10  10  10
44  10  10  10  10  10  10  10  10  10  10  10  255 255 255 255 255 255 255 255 255 255 255 255 255 255 255 255 255 255 255 255 255 255 255 255 255 255 255 255 255 255 255 255 255 10  10  10  10  10  10  10  10  10  10
45  10  10  10  10  10  10  10  10  10  10  10  255 255 255 255 255 255 255 255 255 255 255 255 255 255 255 255 255 255 255 255 255 255 255 255 255 255 255 255 255 255 255 255 255 10  10  10  10  10  10  10  10  10  10
46  10  10  10  10  10  10  10  10  10  10  10  255 255 255 255 255 255 255 255 255 255 255 255 255 255 255 255 255 255 255 255 255 255 255 255 255 255 255 255 255 255 255 255 255 10  10  10  10  10  10  10  10  10  10
47  10  10  10  10  10  10  10  10  10  10  10  255 255 255 255 255 255 255 255 255 255 255 255 255 255 255 255 255 255 255 255 255 255 255 255 255 255 255 255 255 255 255 255 255 10  10  10  10  10  10  10  10  10  10
48  10  10  10  10  10  10  10  10  10  10  10  255 255 255 255 255 255 255 255 255 255 255 255 255 255 255 255 255 255 255 255 255 255 255 255 255 255 255 255 255 255 255 255 255 10  10  10  10  10  10  10  10  10  10
49  10  10  10  10  10  10  10  10  10  10  10  255 255 255 255 255 255 255 255 255 255 255 255 255 255 255 255 255 255 255 255 255 255 255 255 255 255 255 255 255 255 255 255 255 10  10  10  10  10  10  10  10  10  10
50  10  10  10  10  10  10  10  10  10  10  10  255 255 255 255 255 255 255 255 255 255 255 255 255 255 255 255 255 255 255 255 255 255 255 255 255 255 255 255 255 255 255 255 255 10  10  10  10  10  10  10  10  10  10
51  10  10  10  10  10  10  10  10  10  10  10  255 255 255 255 255 255 255 255 255 255 255 255 255 255 255 255 255 255 255 255 255 255 255 255 255 255 255 255 255 255 255 255 255 10  10  10  10  10  10  10  10  10  10
52  10  10  10  10  10  10  10  10  10  10  10  255 255 255 255 255 255 255 255 255 255 255 255 255 255 255 255 255 255 255 255 255 255 255 255 255 255 255 255 255 255 255 255 255 10  10  10  10  10  10  10  10  10  10
53  10  10  10  10  10  10  10  10  10  10  10  255 255 255 255 255 255 255 255 255 255 255 255 255 255 255 255 255 255 255 255 255 255 255 255 255 255 255 255 255 255 255 255 255 10  10  10  10  10  10  10  10  10  10
54  10  10  10  10  10  10  10  10  10  10  10  255 255 255 255 255 255 255 255 255 255 255 255 255 255 255 255 255 255 255 255 255 255 255 255 255 255 255 255 255 255 255 255 255 10  10  10  10  10  10  10  10  10  10
55  10  10  10  10  10  10  10  10  10  10  10  255 255 255 255 255 255 255 255 255 255 255 255 255 255 255 255 255 255 255 255 255 255 255 255 255 255 255 255 255 255 255 255 255 10  10  10  10  10  10  10  10  10  12
