2 4 2 3 0
5 9 7 8 0
1 9 9 9 9
0 0 9 0 9
8 5 9 9 4