2 1 2 3 4
5 9 7 8 9
1 2 3 4 0
0 0 0 0 0
0 0 0 0 0
